10;10
WWWWWWWWWW
W  O     W
W  O     W
W  OO    W
W   O    W
WX  OO   W
WXX  OO  W
WXX   O  W
WXXX  OO W
WWWWWWWWWW